assamese = ['bengali_assamese', 'ahom']
assamese_np = ['latin_alphabet', 'nagamese_creole']
bengali = ['bengali_assamese', 'devanagari', 'devanagari_extended', 'devanagari_extended_A', 'kaithi', 'tirhuta', 'oriya']
bodo = ['bengali_assamese', 'devanagari', 'devanagari_extended', 'devanagari_extended_A']
bodo_np = ['latin_alphabet']
dogri = ['devanagari', 'devanagari_extended', 'devanagari_extended_A', 'mahajani']
dogri_np = ['perso_arabic', 'name_dogra_akkhar']
english = ['latin_english_alphabet', 'anglo_saxon_runes']
gujarati = ['gujarati']
hindi = ['devanagari', 'devanagari_extended', 'devanagari_extended_A', 'kaithi', 'mahajani', 'khojki', 'takri']
hindi_np = ['latin_alphabet', 'khudabadi', 'landa']
kannada = ['kannada']
kashmiri = ['devanagari', 'devanagari_extended', 'devanagari_extended_A', 'sharada']
kashmiri_np = ['perso_arabic']
konkani = ['brahmi', 'modi', 'devanagari', 'devanagari_extended', 'devanagari_extended_A', Roman, 'kannada', 'malayalam', 'nandinagari', 'gujarati', 'kaithi']
konkani_np = ['goykanadi', 'roman']
maithili = ['tirhuta', 'bengali_assamese', 'devanagari', 'devanagari_extended', 'devanagari_extended_A', 'kaithi']
malayalam = ['malayalam', 'grantha', 'brahmi']
malayalam_np = ['latin_alphabet', 'hebrew']
marathi = ['modi', 'devanagari', 'devanagari_extended', 'devanagari_extended_A']
meitei = ['meetei_mayek', 'meetei_mayek_extensions', 'bengali_assamese', 'devanagari', 'devanagari_extended', 'devanagari_extended_A']
meitei_np = ['latin_alphabet']
nepali = ['devanagari', 'devanagari_extended', 'devanagari_extended_A']
odia = ['oriya', 'brahmi', 'bhaiksuki', 'siddham', 'sharada']
punjabi = ['gurumukhi', 'devanagari', 'devanagari_extended', 'devanagari_extended_A', 'mahajani', 'takri', 'khojki']
sanskrit = ['devanagari', 'devanagari_extended', 'devanagari_extended_A', 'brahmi']
santali = ['ol_chiki', 'bengali_assamese', 'oriya']
santali_np = ['roman']
sindhi = ['devanagari', 'devanagari_extended', 'devanagari_extended_A', 'khojki', 'gurumukhi', 'mahajani', 'takri' ]
tamil = ['tamil', 'tamil_supplement', 'grantha', 'brahmi']
tamil_np = ['latin_alphabet']
telugu = ['telugu']
urdu_np = ['perso_arabic', 'urdu', 'roman_urdu', 'hebrew']